%%%%%%%%%%%%%
%           %
%.        %P%
%%%%%%%%%%%%%