%%%%%%%%%%%%%%
%           P%
% % % % % %  %
%% % % % %   %
%            %
%.           %
%%%%%%%%%%%%%%